1111111111
1000000001
1000000001
1001111001
1001001001
1001101001
1000000001
10N0000001
1000000001
1111111111
